11111111111111111111
1EC000000000C00C00C1
1CC011111C111C101101
1C0011111C1110101101
100000000000C000C0C1
1CC11CC01CC1CCCCCCC1
1CCC1CCCCCC1CCCCCCC1
1CCC1CCCCCCCCCCCCCC1
1CC11CC11000000000P1
11111111111111111111
